0 1 0 3 9 0 4 0 5
0 9 0 0 0 7 0 0 2
0 0 3 2 8 0 0 1 0
0 0 1 0 0 2 0 0 4
0 4 0 8 3 0 0 2 7
8 2 0 0 4 0 1 0 3
0 0 0 0 1 0 7 3 8
0 8 0 0 6 3 2 0 0
3 0 4 9 0 0 0 5 1
