0 0 0 0 0 0 1 0 0
0 0 8 0 0 7 0 0 6
0 4 0 0 0 0 0 0 0
0 0 0 3 0 8 0 6 0
0 0 0 0 6 0 4 0 0
0 0 7 0 2 9 0 8 0
6 9 0 7 0 0 0 0 0
0 0 1 0 3 0 0 0 0
4 0 0 1 0 0 3 5 0
