0 0 0 0 0 0 9 8 4
0 0 0 0 9 5 0 0 3
0 4 0 0 0 0 0 5 0
0 0 7 8 4 0 1 0 6
0 0 0 0 0 0 0 0 5
0 0 0 0 7 0 0 0 0
0 6 9 1 0 0 0 7 0
5 8 0 6 0 0 0 0 0
0 0 0 0 0 9 0 0 0
