2 1 0 0 0 5 0 0 3
3 6 0 0 0 0 0 2 4
0 7 0 0 3 0 1 8 0
7 5 0 0 1 0 0 0 0
0 4 6 9 0 2 3 5 0
0 0 0 0 5 0 0 7 6
0 3 7 0 8 0 0 4 0
6 9 0 0 0 0 0 1 7
4 0 0 1 0 0 0 3 5
